6 9 1 1
#########
#^^^^^^^#
#^^b^^x^#
#^^^^^^^#
#^^^^^^^#
#########
7 9 1 1
#########
#^^^^^^^#
#^^b^xx^#
#^^^^b^^#
#^^^^^^^#
#^^^^^^^#
#########
7 9 1 1
#########
#^^^#^^^#
#^b^#^x^#
#^^^##^^#
#^^^^^^^#
#^^^^^^^#
#########
